# # # # # # # # # # # # ,
# . h . . . . . . # a # ,
# . . . . . . . . . . # ,
# e # . . # # # # # # # ,
# . # . . . . . . . e # ,
# . # . . . . . . . . # ,
# . # . . # . . # . . # ,
# . # . . . . . . . . # ,
# . # . . . . . . . . # ,
# . # # . # . . # # . # ,
# . a # . . . . . # h # ,
# # # # # # # # # # # # ,