# # # # # # # # # # # # ,
# . h . . . . . . # a # ,
# . . . . . . . . . . # ,
# . # . . # # # # # # # ,
# . # . . . . . . . . # ,
# . # . . . . . . . . # ,
# . # . . # . . # . . # ,
# e # . . . . . . . . # ,
# . # . . . . . . . . # ,
# . # # . # . . # # . # ,
# . a # . . . . . # h # ,
# # # # # # # # # # # # ,